1111111111111111
1000000100000001
1000000100000001
1000000100000001
1000000100000001
1000000100000001
1000000100000001
1000000100000001
1000000000000001
1000000000000001
1000000000000001
100000S000000001
1000000000000001
1000001000000001
1000000000000001
1111111111111111
