
NO ./textures/north.xpm
SO ./textures/south.xpm
WE ./textures/west.xpm
EA ./textures/east.xpm

F 220,100,0
C 0,255,0


    1111111111111111111111111
    1000000000110000000000001
    1011000001110000000000001
    10010000000000000000000011111111111111111
    11111111111111111011000001110000000000001
        1000000000110000011101111111111111111
        11110111111111011100000010001
        11110111111111011101010010001
        1100000011010101110000001000111111 111111
        1000000000111111111000000000000001 100001
        10000000001       1000000000111111 111111
        10000000001111111110000000001
        10000N00000000001100000010001
        10000000000000001101010010001
        1100000111010101111101111000111
        11110111 1110101 101111010001
        11111111 1111111 111111111111
